0020003000002000
1111113111111111
1111113111111111
1111113111111111
1111113111111111
1111110111111111
1111111111111111
1111111111111111
1111000111111111
0000111111111111
1111111111111111
1111111111111111