00000000000000000000000000000000
0FFFFFFFFFFFFBBBBBBBBBBBBBBBBBS0
0FBBBBBBBFEFFBXXWXXWXXWXXWXXWXD0
0FBXXWXXBFFFFBFEFFFFFFEFFFFFFFF0
0FBFFFFFBFFEFBFFEFFFFEFEFFFFFFF0
0FBFFFFFBEFFFBFFFEFFEFFFEFFFFFF0
0FBFFFFFBFFEFBFFFFEFFFFFFEFFFFF0
0FXFFFFFBFFFEBFFFFBBBFBBBBBBBBB0
0FFBFFFFBFFFFBFFFFBXXDXXWXXWXXW0
0FFBFFFFBFEFFBBBBBBFFFFFFFFFFFF0
0FFBFFFFBFFFFXXWXXBBBBBBBBBBBBF0
0FFBFFFFBFFFFEFFFFBXXWXXWXXWXBF0
0FFBFFFFBBBBBBBFFFBFFEFFFFFFFBF0
0FFBFFFFBXXWXXBFFFBEFFFEFFEFFBF0
0FFBFFFFBFFFFFBFFFBFFFEFFFFFFBF0
0FFBFFFFBFFFFFBFFFBEFFFFFFFFFBF0
0FFBFFFFBFFFFFBFFFBFFEFFFFEFFBF0
0FFBFFFFBFFFFFBEFFBFBXDXBFFFFBF0
0FFBFFFFBFFFFFBFEFBFBFFFBFFFFBF0
0FFBFFFFBFFFFFBFFEBFBFFFBFFFFBF0
0FFBFFFFBFFFFFBFFFBBBFFFBFFFFBF0
0FFBFFFFBFFFFFBFFFXWXFFFBFFFFWF0
0FFBFFFFBFFFFFBKFFFFFFFFBFFFFFF0
00000000000000000000000000000000