000000000000000000000000000000000000000000
0XXWXXXXXXWXXXXXBBBBBBBBBBBBBBBBBBSBBBBBB0
0FFFFFFFFFFFFFFFBXXWXXWXXWXXWXXWXXDXXWXXW0
0FBBBBBBBBBFFFFFBFFFFFFFFFFFFFFFFFFFFFFFF0
0FBXXXXXXXBFFFEFBFFFFFFFFFFFFFFFFFFFFFFFF0
0FBFFFFFFFBEFFFFBFFFFFFFFFFFFFFFFFFFFFFFF0
0FBFFFFFFFBFFFFFBFFFFFFFFFFFFFFFFFFFFFFFF0
0FBFFFFFFFBFFFEFBFFFFFFFFFFFFFFFFFFFFFFFF0
0FXFFFFFFFBFFFFFBFFFFFFFFFFFFFFFFFFFFFFFF0
0FFBFFFFFFBFFFFFBFFFFFFFFFFFFFFFFFFFFFFFF0
0FFBFFFFFFBFFEFFBFFFFFFFFFFFFFFFFFFFFFFFF0
0FFBFFFFFFBFFFFFBFFFFFFFFFFFFFFFFFFFFFFFF0
0FFBFFFFFFBEFFFFBFFFFFFFFFFFFFFFFFFFFFFFF0
0FFBFFFFFFBFEFFFBFFFFBBBFBBBBBBBBBBBBBBBB0
0FFBFFFFFFBFFEFFBFFFFBXXDWXXWXXWXXWXXWBXX0
0FFBFFFFFFBFFFEFBBBBBBFFFFFFFFFFFFFFFFBFF0
0FFBFFFFFFBFFFFEXXWXXBBBBBBBBBBBBBBBFFBFF0
0FFBFFFFFFBFFFFFFFFFFBXXWXXWXXWXXWXBFFBFF0
0FFBFFFFFFBBBBBBBFFFFBFEFFFFFFFFFFFBFFBFF0
0FFBFFFFFFBXXWXXBFFFFBFFFEFFFFFEFEFBFFBFF0
0FFBFFFFFFBFFFFFBFFFFBFFFEFFFFFFFFFBFFBFF0
0FFBFFFFFFBFFFFFBFFFFBFFFFFFEFFFFFFBFFBFF0
0FFBFFFFFFBFFFFFBFFFFBFFFFFFFEFFFFFBFFBFF0
0FFBFFFFFFBFFFFFBFFFFBFFFFEFFFFFFEFBFFBFF0
0FFBFFFFFFBFFFFFBFFFFBFFFFFFFEFFFFFBFFBFF0
0FFBFFFFFFBFFFFFBFFFFBFFFFFFFFFFFFFBFFBFF0
0FFBFFFFFFBFFFFFBFFFFBFBXDXBFFFEFFFBFFBFF0
0FFBFFFFFFBFFFFFBFFFFBFBFFFBFFFFFFEBFFBFF0
0FFBFFFFFFBFFFFFBFFFFBBBFFFBFFEFFFFBFFBFF0
0FFBFFFFFFBFFFFFBFFFFXWXFFFBFFFFEFFXFFBFF0
0FFBFFFFFFBFFFFFBFFFKFFFFFFBFFFFEFFFFFBFF0
000000000000000000000000000000000000000000
