0XXWXXW~~WXXWWX0
0~~~~~~~~~~~~~~0
0~~~~~~~~~~~~~~0
0~~~~~~~~~~~~~~0
0~~~~~~~~~~~~~~0
~~~~~~~~~~~~~~~~
~~~~~~~~~~~~~~~~
0~~~~~~~~~~~~~~0
0~~~~~~~~~~~~~~0
0~~~~~~~~~~~~~~0
0~~~~~~~~~~~~~~0
0000000~~0000000