0XWWXXMXWXMMMMXXWWXXW0
0~~~~~~~~~~~~~~~~~~~~0
0~~~~~~~~~e~~~~~~~~~~0
0~~~~~~~~~~~~~~~~~~~~0
0~~~~~~~~~~~~~~~~~~~~0
0~~~~~~[]~~~~~~~~~~~~0
0~~~~~~~~~~~[]~~~~~~~0
0~~~~~~~~~~~~~~~~~~~~0
0~~~~~~~~~~~~~~~~~~~~0
0~~~~~~~~~~~~~~~~~~~~0
0~~~~~~~~~~~~~[]~~~~~0
0~~~~~[]~~~~~~~~~~~~~0
0~~~~~~~~~~~~~~~~~~~~0
0~~~~~~~~~~~~~~~~~~~~0
0~~~~~~~~~~~~~~~~~~~~0
0000000000000000000000
