0XXWXXW~~WXXWWX0
0~~~~~~~~~~~~~~0
0~~~~~~~~~~~~~~0
0~~~~~~~~~~~~~~0
W~~~~~~~~~~~~~~W
~~~~~~~~~~~~~~~~
~~~~~~~~~~~~~~~~
0~~~~~~~~~~~~~~0
0~~~~~~~~~~~~~~0
0~~~~~~~~~~~~~~0
0~~~~~~~~~~~~~~0
0000000~~0000000

0XXWXXW~~WXBBSB0
0~~~~~~~~~~BB~BB
0~~e~~~~~~~WLDR0
0~~~~~~~~~~~~~~0
W~~~e~~~~~~~~~~W
~~~~~~~~~~~~~~~~
~~~~~~e~~~~~~~~~
0~~~~~~~~~~~~~~0
0~~~~~~~e~~~~~~0
0~~~~~~~~~~~~~~0
0~~~~~~~~~e~~~~0
0000000~~0000000

0XXWXXW~~WXXXXX0
0~~~~~~~~~~~~~~0
0~~~~BBBBBB~~~~0
0~~~~BXXXXB~~~~0
W~~~~B~I~~B~~~~W
~~~~~B~~~~B~~~~~
~~~~~B~k~~B~~~~~
0~~~~BBB~BB~~~~0
0~~~~WXLDRW~~~~0
0~~~~~~~~~~~~~~0
0~~~~~~~~~~~~~~0
0000000~~0000000

0XXWXXW~~WXXXXX0
0~~~~~~~~~~~~~~0
0~~~~BBBBBB~~~~0
0~~~~BXXXXB~~~~0
W~~~~B~I~~B~~~~W
~~~~~B~~~~B~~~~~
~~~~~B~~~~B~~~~~
0~~~~BBB~BB~~~~0
0~~~~WXX~XW~~~~0
0~~~~~~~~~~~~~~0
0~~~~~~~~~~~~~~0
0000000~~0000000

0XXWXXW~~WXXWXX0
0~~~~~~~~~~~~~~0
0~~~~~~~~~~~~~~0
0[]~~~~~~~~~~[]0
W~~~~~~~~~~~~~~W
~~~~~~BBB~~~~~~~
~~~~~~BWB~~~~~~~
0~~~~~WkW~~~~~~0
0[]~~~~~~~~~~[]0
0~~~~~~~~~~~~~~0
0~~~~~~~~~~~~~~0
0000000~~0000000

0XXWXXW~~WXXWXX0
0~e~~~e~~e~~~e~0
0~~~e~~~~~~e~~~0
0BBBBB~~~~BBBBB0
WXXWXX~~~~XXWXXW
~~~~~~~~~~~~~~~~
~~~~~~~~e~~~~~~~
0~~e~~~~~~~~e~~0
0[][]~~~e~~[][]0
0~~~~~~~~~~~~~~0
0~~~~~~~~~~~~~~0
0000000~~0000000

0WXWXBX~~WBWXXX0
0~~~~B~~~~Be~~~0
0~~~~Be~~~B~e~~0
0~e~~B~e~~B~~e~0
W~~e~B~~e~B~~~eW
~~~~BB~~~eBB~~~~
~~~~XX~~~~XX~~~~
0~~~~~~~~~~~~~~0
0~~~~~~~~~~~~~~0
0~~~~~~~~~~~~~~0
0~~~~~~~~~~~~~~0
0000000~~0000000

0XXWXXW~~WXWXXX0
0~~~~~~e~~~~~~~0
0~~~~~~~~~~~~~~0
0BBBBBBBB~~BBBB0
XWWBXWXXW~~XXWXW
~~~B~e~~~~~~e~~~
~~~B~~e~~~~~~e~~
0~~BBBBBB~~BBBB0
0~~XWXXWX~~XXWX0
0~~~~~~~~~~~~~~0
0~~~e~~~~~~~~~~0
0000000~~0000000

0XWXWXW~~XWWWXW0
0~~~~~~~~~~~~~~0
0~~~~~~~~~~~~~~0
0BBBBB~e~~BBBBB0
WXXWXX~~e~WXXXXW
~~~~~~~~~~~~~~~~
~~~~~~[][]~~~~~~
0~e~~~~~~~~~~e~0
0[][]~~~~~~[][]0
0~~~~~~~e~~~~~~0
0~~~~e~~~~~e~~~0
0000000~~0000000

0XXXWXX~~XXXXXX0
0~~e~~~~~~~~e~~0
0~~~~~~~e~~~~~~0
0BB~~BBBBBB~~BB0
WXX~~XWXXWX~~XXW
~~~e~~~~~~e~~~~~
~~~~~~~e~~~~~~~~
0BB~~BBBBBB~~BB0
0XX~~XWXXWX~~XX0
0~~~~~~~e~~~~~~0
0~~e~~~~~~~e~~~0
0000000~~0000000

0WXXXWX~~WWXXXX0
0~~e~~~~~~~~e~~0
0~~~~~~~[][]~~~0
0~~BBB~~~~~~~e~0
W~~BXW~~~~~~~~~W
~~~B~~~~[][]~e~~
~~~B~e~~~~~~~~~0
0~~B~~BBBBBBBBB0
0~~X~~WXXWXXXWX0
0~~~~~~~e~~e~~~0
0~~~e~~~~~~~~~~0
0000000~~0000000

0XWWXWW~~WXWXXX0
0~~~~~~~~~~~e~~0
0~~~~e~~~~~e~~~0
0~~[]~e~~~~[]~~0
W~~~~~~~~~~e~~~W
~~~~~e~[]~e~~~~~
~~~~~~e~~~~~~~~~
0~~~~~~~~~~e~~~0
0~~[]e~~~~e[]~~0
0~~~~~e~~~~~~~~0
0~~~~~~~~~~e~~~0
0000000~~0000000

0XXXXWX~~XWXXXX0
0~~~~~~~~~~e~~~0
0~~~e~~~~~~~~e~0
0BBBB~~~~~~BBBB0
WXWXW~~~~~~WXXXW
~~~~~~~~~~~~~e~~
~~~~~~~e~~~~~~~~
0BBBB~~~~~~BBBB0
0WXXW~~~~~~WXXW0
0~~~~~e~~~~~~~~0
0~~~~~~~~~e~~~~0
0000000~~0000000

0XXWXXW~~XXWXXW0
0~e~~~~~~~~~~e~0
0~~~e~~~~~~e~~~0
0BBBBBB~~BBBBBB0
WXXWXXX~~XXXWXXW
~~~~~e~~~~~e~~~~
~~~~~~~~e~~~~~~~
0BB~~BB~~BB~~BB0
0MM~~MB~~BM~~MM0
0e~~~~B~~B~~~~e0
0~~~e~B~~B~e~~~0
0000000~~0000000

0XWXWXW~~XWXWXW0
0~~~~~~~~~~~~e~0
0~~BB~~~~~~e~~~0
0~~MM~~BB~~~~~~0
W~~~~~~MM~~BB~~W
~~~~~~~~~~~MM~~~
~~~BBBB~~~~~~~~~
0~~XWXW~~BBBB~~0
0~~~~~~~~XWXW~~0
0~~e~~~e~~~~~~~0
0~~~~~~~~e~~~~~0
0000000~~0000000

0XXXWXX~~XXXWXX0
0~~~~~~~~~~~~~~0
0~~B~~~~~~e~~~~0
0~~B[]e~~~~~~~~0
X~~M~~~~~~B~~~~X
~~~~~~~~~~B[]e~~
~~~~e~~~~~M~~~~~
0~~B~~~~~~~~~~~0
0~~B[]~~e~~~~~~0
0~~M~~~~~~~~~~~0
0~~~~~~~~~e~~~~0
0000000~~0000000

0XXWXXW~~XXWXXW0
0~~~~~~~~~~~~~~0
0~~B~~~BBBBBB~~0
0~~B~~~XXWXXB~~0
W~~B~e~~~~~~B~~W
~~~B~~~e~~~~B~~~
~~~B[]~~~e[]B~~~
0~~B~~~~~~~eB~~0
0~~BBBBBBBBBB~~0
0~~MXXXXXXXXM~~0
0~~~~~~~~~~~~~~0
0000000~~0000000

0XXXXXX~~XXXXXX0
0~~e~~~~~~~e~~~0
0~~[]~~e~~~[]~~0
0~~e~~~~~~~e~~~0
X~~BBBBBBBBBB~~X	
~~~BXXXMXXXWB~~~
~~~B~~~e~~~~B~~~
0~~B~e~~~e~~B~~0
0~~BBBB~~BBBB~~0
0~~MWWW~~WWWM~~0
0~~~~~~~~~~~~~~0
0000000~~0000000

0WXXXWX~~XXWXXW0
0~~~~~~~~e~~~~~0
0~~B[]~~~~~~B~~0
0~~B~~e~~~~~B~~0
W~~B~~~~~~[]B~~0
~~~B~~~~~e~~B~~~
~~~B[]~~~~~~B~~~
0~~B~~e~~~~~B~~0
0~~B~~~~~~[]B~~0
0~~M~~~~~e~~M~~0
0~~~~~~~~~~~~~~0	
0000000~~0000000

0XXWXXW~~WXXWXX0
0~~~~~~~~~~~~~~0
0~~~~~~~~~~~~~~0
0~BBB~~e~~BBB~~0
W~WMW~~~~~WMW~~W
~~~~~~~e~~~~~~~~
~~~e~~~e~~~~e~~~
0~~~~~BBB~~~~~~0
0~~e~~WMW~~~~~e0
0[]~~~e~~~~e~[]0
0~~~~~~~~e~~~~~0
0000000~~0000000

0XXWXXW~~WXXWXX0
0~e~~~~~~~~~~e~0
0~~~~~~~e~~~~~~0
0~~BBBBBBBBBB~~0
X~~MMMXXMMMXX~~X
~~~~~~~e~~~~~~~~
~~~~~e~~~~e~~~~~
0~~BBBBBBBBBB~~0
0~~MMMXXMMMXX~~0
0~~~~~~e~~~~~~~0
0~e~~~~~~~~~~e~0
0000000~~0000000

0XXXXXX~~XXXXXX0
0~e~~~~~~~~~~e~0
0~~[][]~~[][]~~0
0~~~~~~~~~~~~~~0
W~~~~~~e~~~~~~~W
~~~~BBBBBBBB~~~~
~~~~MXWMXWXM~~~~
0~~~~~~e~~~~~~~0
0~~[][]~~[][]~~0
0~~~~~~~~~~~~~~0
0~e~~~~e~~~~~e~0
0000000~~0000000 

0XWXWXW~~XWXWXW0
0~~~~~~~~~~~~~~0
0~~[][]~~[][]~~0
0~~~~~~e~~~~~~~0
W~~~~~~~~~~~~~~W
~~e~~[][][]~~e~~
~~~~~~~e~~~~~~~~
0~~~~~~~~~~~~~~0
0~~[][]~~[][]~~0
0~~~~~~e~~~~~~~0
0~~~~~~~~~~~~~~0
0000000~~0000000

